"filename", "language", "TypeScript JSX", "TypeScript", "XML", "CSS", "comment", "blank", "total"
"c:\Users\Maciej\Desktop\vite-template-master\src\App.tsx", "TypeScript JSX", 11, 0, 0, 0, 0, 2, 13
"c:\Users\Maciej\Desktop\vite-template-master\src\PrivateRoute.tsx", "TypeScript JSX", 9, 0, 0, 0, 0, 2, 11
"c:\Users\Maciej\Desktop\vite-template-master\src\Router.tsx", "TypeScript JSX", 52, 0, 0, 0, 0, 4, 56
"c:\Users\Maciej\Desktop\vite-template-master\src\components\CardMenu\CardMenu.tsx", "TypeScript JSX", 45, 0, 0, 0, 0, 8, 53
"c:\Users\Maciej\Desktop\vite-template-master\src\components\CardMenu\CardMenuPlaylistModal.tsx", "TypeScript JSX", 93, 0, 0, 0, 0, 19, 112
"c:\Users\Maciej\Desktop\vite-template-master\src\components\ColorSchemeToggle\ColorSchemeToggle.tsx", "TypeScript JSX", 11, 0, 0, 0, 0, 3, 14
"c:\Users\Maciej\Desktop\vite-template-master\src\components\DashboardDiscover\GenreModal.tsx", "TypeScript JSX", 120, 0, 0, 0, 0, 13, 133
"c:\Users\Maciej\Desktop\vite-template-master\src\components\DashboardDiscover\Genres.module.css", "CSS", 0, 0, 0, 7, 0, 4, 11
"c:\Users\Maciej\Desktop\vite-template-master\src\components\DashboardDiscover\Genres.tsx", "TypeScript JSX", 140, 0, 0, 0, 0, 17, 157
"c:\Users\Maciej\Desktop\vite-template-master\src\components\DashboardDiscover\Headers.module.css", "CSS", 0, 0, 0, 9, 0, 0, 9
"c:\Users\Maciej\Desktop\vite-template-master\src\components\DashboardDiscover\HeroDiscover.tsx", "TypeScript JSX", 19, 0, 0, 0, 0, 4, 23
"c:\Users\Maciej\Desktop\vite-template-master\src\components\DashboardDiscover\NewReleases.module.css", "CSS", 0, 0, 0, 42, 0, 9, 51
"c:\Users\Maciej\Desktop\vite-template-master\src\components\DashboardDiscover\NewReleases.tsx", "TypeScript JSX", 140, 0, 0, 0, 0, 13, 153
"c:\Users\Maciej\Desktop\vite-template-master\src\components\DashboardDiscover\Trending.tsx", "TypeScript JSX", 142, 0, 0, 0, 0, 23, 165
"c:\Users\Maciej\Desktop\vite-template-master\src\components\DashboardHome\Hero.module.css", "CSS", 0, 0, 0, 62, 0, 9, 71
"c:\Users\Maciej\Desktop\vite-template-master\src\components\DashboardHome\Hero.tsx", "TypeScript JSX", 25, 0, 0, 0, 0, 4, 29
"c:\Users\Maciej\Desktop\vite-template-master\src\components\DashboardHome\Top10.module.css", "CSS", 0, 0, 0, 42, 0, 9, 51
"c:\Users\Maciej\Desktop\vite-template-master\src\components\DashboardHome\Top10.tsx", "TypeScript JSX", 97, 0, 0, 0, 0, 15, 112
"c:\Users\Maciej\Desktop\vite-template-master\src\components\DashboardPlaylists\PlaylistCardMenu.tsx", "TypeScript JSX", 72, 0, 0, 0, 0, 13, 85
"c:\Users\Maciej\Desktop\vite-template-master\src\components\DashboardPlaylists\PlaylistCreateModal.tsx", "TypeScript JSX", 48, 0, 0, 0, 0, 12, 60
"c:\Users\Maciej\Desktop\vite-template-master\src\components\DashboardPlaylists\PlaylistDeleteConfirmationModal.tsx", "TypeScript JSX", 0, 0, 0, 0, 0, 1, 1
"c:\Users\Maciej\Desktop\vite-template-master\src\components\DashboardPlaylists\PlaylistHero.tsx", "TypeScript JSX", 22, 0, 0, 0, 0, 5, 27
"c:\Users\Maciej\Desktop\vite-template-master\src\components\DashboardPlaylists\PlaylistModal.tsx", "TypeScript JSX", 73, 0, 0, 0, 0, 9, 82
"c:\Users\Maciej\Desktop\vite-template-master\src\components\DashboardPlaylists\Playlists.tsx", "TypeScript JSX", 95, 0, 0, 0, 0, 19, 114
"c:\Users\Maciej\Desktop\vite-template-master\src\components\DashboardProfile\ProfileCard.tsx", "TypeScript JSX", 69, 0, 0, 0, 0, 11, 80
"c:\Users\Maciej\Desktop\vite-template-master\src\components\DashboardProfile\ProfileData.tsx", "TypeScript JSX", 104, 0, 0, 0, 0, 16, 120
"c:\Users\Maciej\Desktop\vite-template-master\src\components\DashboardRecommendation\CollabFilteringRecommendationModal.tsx", "TypeScript JSX", 225, 0, 0, 0, 0, 32, 257
"c:\Users\Maciej\Desktop\vite-template-master\src\components\DashboardRecommendation\ContentBasedRecommendationModal.tsx", "TypeScript JSX", 274, 0, 0, 0, 0, 25, 299
"c:\Users\Maciej\Desktop\vite-template-master\src\components\DashboardRecommendation\HeroRecommendation.tsx", "TypeScript JSX", 19, 0, 0, 0, 0, 3, 22
"c:\Users\Maciej\Desktop\vite-template-master\src\components\DashboardRecommendation\RecommendationButtons.tsx", "TypeScript JSX", 51, 0, 0, 0, 0, 18, 69
"c:\Users\Maciej\Desktop\vite-template-master\src\components\DashboardRecommendation\RecommendationManual.module.css", "CSS", 0, 0, 0, 14, 0, 2, 16
"c:\Users\Maciej\Desktop\vite-template-master\src\components\DashboardRecommendation\RecommendationManual.tsx", "TypeScript JSX", 303, 0, 0, 0, 0, 36, 339
"c:\Users\Maciej\Desktop\vite-template-master\src\components\DashboardRecommendation\RecommendationManualModal.tsx", "TypeScript JSX", 117, 0, 0, 0, 0, 12, 129
"c:\Users\Maciej\Desktop\vite-template-master\src\components\Login\Login.module.css", "CSS", 0, 0, 0, 22, 0, 6, 28
"c:\Users\Maciej\Desktop\vite-template-master\src\components\Login\Login.tsx", "TypeScript JSX", 131, 0, 0, 0, 0, 27, 158
"c:\Users\Maciej\Desktop\vite-template-master\src\components\Navbar\Navbar.module.css", "CSS", 0, 0, 0, 57, 0, 10, 67
"c:\Users\Maciej\Desktop\vite-template-master\src\components\Navbar\Navbar.tsx", "TypeScript JSX", 66, 0, 0, 0, 0, 8, 74
"c:\Users\Maciej\Desktop\vite-template-master\src\components\SearchBar\Searchbar.tsx", "TypeScript JSX", 33, 0, 0, 0, 0, 8, 41
"c:\Users\Maciej\Desktop\vite-template-master\src\components\SearchBar\SearchbarModal.tsx", "TypeScript JSX", 106, 0, 0, 0, 0, 17, 123
"c:\Users\Maciej\Desktop\vite-template-master\src\components\Welcome\Welcome.module.css", "CSS", 0, 0, 0, 9, 0, 2, 11
"c:\Users\Maciej\Desktop\vite-template-master\src\components\Welcome\Welcome.story.tsx", "TypeScript JSX", 5, 0, 0, 0, 0, 3, 8
"c:\Users\Maciej\Desktop\vite-template-master\src\components\Welcome\Welcome.test.tsx", "TypeScript JSX", 11, 0, 0, 0, 0, 2, 13
"c:\Users\Maciej\Desktop\vite-template-master\src\components\Welcome\Welcome.tsx", "TypeScript JSX", 22, 0, 0, 0, 0, 2, 24
"c:\Users\Maciej\Desktop\vite-template-master\src\contexts\AudioProvider.tsx", "TypeScript JSX", 41, 0, 0, 0, 0, 8, 49
"c:\Users\Maciej\Desktop\vite-template-master\src\favicon.svg", "XML", 0, 0, 1, 0, 0, 1, 2
"c:\Users\Maciej\Desktop\vite-template-master\src\main.tsx", "TypeScript JSX", 4, 0, 0, 0, 0, 2, 6
"c:\Users\Maciej\Desktop\vite-template-master\src\pages\Dashboard.page.tsx", "TypeScript JSX", 29, 0, 0, 0, 0, 5, 34
"c:\Users\Maciej\Desktop\vite-template-master\src\pages\DashboardDiscover.page.tsx", "TypeScript JSX", 19, 0, 0, 0, 0, 5, 24
"c:\Users\Maciej\Desktop\vite-template-master\src\pages\DashboardHome.page.tsx", "TypeScript JSX", 13, 0, 0, 0, 0, 3, 16
"c:\Users\Maciej\Desktop\vite-template-master\src\pages\DashboardPlaylists.page.tsx", "TypeScript JSX", 10, 0, 0, 0, 0, 3, 13
"c:\Users\Maciej\Desktop\vite-template-master\src\pages\DashboardProfile.page.tsx", "TypeScript JSX", 13, 0, 0, 0, 0, 3, 16
"c:\Users\Maciej\Desktop\vite-template-master\src\pages\DashboardRecommendation.page.tsx", "TypeScript JSX", 17, 0, 0, 0, 0, 4, 21
"c:\Users\Maciej\Desktop\vite-template-master\src\pages\Home.page.tsx", "TypeScript JSX", 11, 0, 0, 0, 0, 2, 13
"c:\Users\Maciej\Desktop\vite-template-master\src\svg\Disque_Vinyl.svg", "XML", 0, 0, 120, 0, 0, 48, 168
"c:\Users\Maciej\Desktop\vite-template-master\src\svg\Full_Logo_Black_RGB.svg", "XML", 0, 0, 1, 0, 0, 0, 1
"c:\Users\Maciej\Desktop\vite-template-master\src\theme.ts", "TypeScript", 0, 3, 0, 0, 1, 2, 6
"c:\Users\Maciej\Desktop\vite-template-master\src\types\playlistTypes.tsx", "TypeScript JSX", 27, 0, 0, 0, 0, 9, 36
"c:\Users\Maciej\Desktop\vite-template-master\src\vite-env.d.ts", "TypeScript", 0, 0, 0, 0, 1, 1, 2
"Total", "-", 2934, 3, 122, 264, 2, 553, 3878